NO   textures/brick-wall_.xpm  
SO    textures/brick-wall_.xpm 
WE 	textures/brick-wall_.xpm 
				EA       textures/brick-wall_.xpm
	

F 51, 198 ,  200
C 184,13,39

111111111111111111
100000000000000111
1000000000N0000011
10000001d100000011
111111111111111111