NO     texc.xpm
SO    texc.xpm
WE texc.xpm




EA       texc.xpm



F 51, 198 ,  200
C 184,13,39

       
1111111111
1000000001
100000111
1000000001
1000000001
1E00000001
1111111111