NO   textures/wallgris3.xpm  
SO    textures/wallgris3.xpm 
WE 	textures/wallgris3.xpm 
				EA       textures/wallgris3.xpm
	

F 97, 97 ,  97
C 40,45,63


111111111111111111
100000000000000111
100000000N00000011
10000001d10000001
111111111111111111