C 51,198,200
F 184,13,39
NO     main.c
SO    main.c
WE main.c
EA main.c



       
  11111111111                 
         111111111  11111111111111111111111111
         100000001  100000000000000001
         10110000111100000001111111111
11111111110000000000000000011111
10000000111100010000000001001
100000001  100110101110000001
10000000111110000001 10100001
11111111111111111111 11111111
1111 111111111111111111111111
1111 100000000000000000000001
1111111111111111111111111111111


       
