NO   textures/wallgris3.xpm
SO    textures/wallgris3.xpm 
WE 	textures/wallgris3.xpm 
EA       textures/wallgris3.xpm
  	

C 97, 97 ,  97
F 40,45,63 








111111111111111111111
10000000000000111
10000N0010000001
110001001011111111
111111d111111111
1d1   1
11