NO   textures/wallgris3.xpm
SO    textures/wallgris3.xpm 
WE 	textures/wallgris3.xpmp 
EA       textures/wallgris.xpm
  	

C 97, 97 ,  97
                       F 40,45,14 


    111111111111111111111
    10000000000000111
    10000000N00000011
    10000001001011111111
    11111111111111111