NO   textures/wallgris3.xpm
SO    textures/wallgris3.xpm 
WE 	textures/wallgris3.xpm 
EA       textures/wallgris3.xpm
	

C 97, 97 ,  97
F 40,45,63 


11111111111111111
10000000000000111
10000000N000000011
10000001d100000011111111
11111111111111111
1           1
