1111111111111111111111111111111111111
10000000000000000001111111000000000001
10000000000000000000000000000000000001
10000000000000000000000000000000001111
10000000000000000000000000000000000001
10000000010111111111100000000000000011
10000000000000000000000000000000000001
10000000000000000000000000000000000001
10000000000000000000000000000000000001
1000000000000001111111000000000000000001
10000000000000000000000000000000000001
10000000000000000000000000000000000001
10000100000000000000000000000000000001
10001010000000000000000000000000000001
10000100000000000000000000000000000001
1000000000000001110000000000000000001
1111111111111111  11111111111111111111
