NO     texc.xpm
SO    texc.xpm
WE texc.xpm
EA                                                   texc.xpm



F 51, 198 ,  200
C 184,13,39
       
1111111111111111111111111111111111111111111111111111
1000000000000000000000010000000000000000000000000001
1000000010000000000000000000000000000000000000000001
100000010000000000000000000000000000000000000000001
1000000000000000000000000000000000000000000000000001
1000000000000000000000000000000000000000000000000001
1000000000000011100011110001111000111000000000000001
1000000000000000100000010000001000001000000000000001
1000000000000000100011110001111000001000000000000001
1000000000000000100000010000001000001000000000000001
1000000000000011110011110001111000001000000000000001
1000000000000000000000000000000000000000000000000001
10000000000000000000N0000000000000000000000000000001
1111111111111111111111111111111111111111111111111111