NO   textures/brick-wall_.xpm  
SO    textures/brick-wall_.xpm 
WE 	textures/brick-wall_.xpm 
				EA       textures/brick-wall_.xpm
	


111111111111111111
100000000000000011
111111111111111111