NO   textures/wall_1.xpm  
SO    texc.xpm
WE texc.xpm




EA       texc.xpm



F 51, 198 ,  200
C 184,13,39

       
111111111111111111111111111111
100000000000000000000000000001
1000000000000N000000000000001
100000000000000000000000000001
100000000000000000000000000001
100000000000000000000000000001
10000000000000000000000000001
100000000000000000000000000001
100000000000000000000000000001
100000000000000000000000000001
100000000000000000000000000001
111111111111111111111111111111