NO   textures/brick-wall_.xpm  
SO    textures/brick-wall_.xpm 
WE 	textures/brick-wall_.xpm 
EA       textures/brick-wall_.xpm


F 51, 198 ,  200
C 184,13,39

       
11111111111111111111111111111
10000000001100000000000000001
10110000011100000000000010001
10010000000000000000000010001
10110000011100000000000010001
10000000001100000111011110001
11110111111111011100000010001
11110111111111011101010010001
11000000110101011d00000010001
10000000000000001100000010001
10000000000000001100010000001
1100000011d10100000001d100001
11111111110101000000000000001
10000000001100000100000010001
10000000000000000000000001001
10000000001000010000N00001001
10000000001101000000000000001
10000000000100000001010000001
11111111111111111111111111111