NO     textures/wall_1.xpm    textures/wall_1.xpm
SO    main.c    
WEo Cub3d.h    
EA textures/wall_1.xpm 

F 184,   113,39
C 51,198,200


       
  11111111111                 
         111111111  111111111111111111
         100000001  100000000000000001
         10110000111100000001111111111
11111111110000000000000000011111
1000000011110001000000000100
100000001  100110101110000001
10000000111110000001 10100001
11111111111111111111 11111111
1111 111111111111111111111111
1111 100000000000000000000001
11111111111111111111111111111


       
