NO   ../textures/wallgris3.xpm
SO   ../textures/wallgris3.xpm
WE 	../textures/wallgris3.xpm 
EA       ../textures/wallgris3.xpm
  	

C 97, 97 ,  97
F 40,45,63 








11111111111111111111111111111
10000000001100000000000000001
10110000011100000000000010001
10010000000000000000000010001
10110000011100000000000010001
10000000001100000111011110001
11110111111111011100000010001
111101111111111011101010010001
11000000110101011000000010001  
10000000000000001100000010001
1000000000000001100010000001
11000000111101000000010100001
11111111111101000000000000001
10000000001100000100000010001
1000000000000000000000001001
10000000001000010000000001001
10000000001101000000000000001
1000N00000100000001010000001
1111111111111111111111111111
