NO   /Users/cmaami/Desktop/cub/textures/wallgris3.xpm
SO    /Users/cmaami/Desktop/cub/textures/wallgris3.xpm 
WE 	/Users/cmaami/Desktop/cub/textures/wallgris3.xpm 
EA       /Users/cmaami/Desktop/cub/textures/wallgris3.xpm
  	

C 97, 97 ,  97
F 40,45,63 








111111111111111111111
10000000000000111
10000N0010000001
110001001011111111
1111111111111111